V111111111110
1CV1CCC10HV1V
EH01C11001101
H100P11101111
011111H111HVH
