1111111111111
1001000100001
100001C000001
110P0101010E1
1111111111100
