V11111111111H
1CV1CCC10HV1V
EH01C10001101
H10P011101111
011111H111HVH
