111111111
1CCCCCCE1
1CCCCC111
1C1111111
1CCCCCCC1
111111C11
1CCCCCCC1
11111C111
1CCCCCCC1
1CCCCCCC1
1CCCCCCC1
11110P111
1CCCC1111
111111111
