011111110
101C01101
1P010V1E0
100C00001
011111110
